▒▒▒▒▒▒▒▒▒▒▒▒▒▒▒▒▒▒▒▒▒▒▒▒▒▒▒▒▒▒▒▒▓▓████████████████████████████████████████████████████████████████████████████████████████████████████████▒▒░░░░░░░░░                    ░░░░░░░░░▒▒▒▒▒▒▒▒▒
▒▒▒▒▒▒▒▒▒▒▒▒▒▒▒▒▒▒▒▒▒▒▒▒▒▒▒▒▒▒▒▒▓▓████████████████████████████████████████████████████████████████████████████████████████████████████████▒▒░░░░░░░░░░░░            ░░░░░░░░░░░░░░▒▒▒▒▒▒▒▒▒
▓▓▓▓▓▓▓▓▓▓▓▓▓▓▓▓▒▒▒▒▒▒▓▓▓▓▓▓▓▓▓▓▓▓▓▓████████████████████████████████████████████████████████████████████████████▒▒▓▓██████████████████████▒▒░░▒▒▒▒▒▒▒▒▒▒▒▒▒▒▒▒▒▒▒▒▒▒▒▒▒▒▒▒▒▒▓▓▓▓▓▓▒▒░░░░░░░
▒▒▒▒▓▓▒▒▒▒▒▒▒▒▒▒▒▒▒▒▒▒▒▒▒▒▒▒▒▒▒▒▒▒▒▒▓▓████████████████████████████████████████████████████████████████████████░░░░░░▓▓████████████████▓▓▒▒▒▒▒▒▒▒░░░░░░░░░░░░░░░░░░▒▒▒▒▒▒▒▒▒▒▒▒▒▒▓▓░░▒▒▒▒▒▒▒
▒▒▒▒▒▒▒▒▓▓▓▓▒▒▒▒▒▒▒▒▒▒▒▒▒▒▒▒▒▒▒▒░░░░▒▒████████████████████████████████████████████████████████████████████▓▓░░░░░░░░██████████████████▓▓░░░░░░░░░░░░░░░░░░░░░░░░░░░░░░▒▒▒▒▒▒▒▒▒▒▒▒▒▒▓▓▓▓▓▓▓
▒▒▒▒▒▒▒▒▒▒▒▒▒▒▒▒▓▓▓▓▒▒▒▒▒▒▒▒▒▒▒▒▒▒▒▒▒▒██████████████████████████████████████████████████████████████████▓▓░░░░░░  ░░██▓▓░░████████████▓▓░░░░░░░░░░░░░░░░░░░░░░░░░░░░░░░░▒▒▒▒▒▒▒▒▒▒▒▒▒▒▒▒▒▒▒
▒▒▒▒▒▒▒▒▒▒▒▒▒▒▒▒▒▒▓▓▓▓▓▓▓▓▓▓▓▓▓▓▒▒▒▒▓▓██████████████▓▓░░▒▒████████████████████████████████████████████▓▓░░░░░░░░░░▒▒░░░░░░░░▓▓████████▓▓░░░░░░░░░░░░░░░░░░░░░░░░░░░░░░░░░░▒▒▒▒▒▒▓▓▓▓▒▒▒▒▒▒▒
▒▒▒▒▒▒▒▒▒▒▒▒▒▒▒▒▒▒▓▓▓▓▓▓▓▓▒▒▒▒▒▒▒▒▒▒▒▒████████████▒▒░░░░░░░░▒▒████████████████████████████████████████░░░░░░░░░░░░░░░░░░░░░░██▓▓████████▓▓▒▒▒▒▒▒▒▒▒▒▒▒▒▒▒▒▒▒▒▒▒▒▒▒▒▒▒▒▒▒▒▒▒▒▒▒▓▓▓▓▓▓▓▓▒▒▓▒▒
▒▒▒▒▒▒▒▒▒▒▒▒▒▒▒▒▒▒▓▓▓▓▓▓▓▓▒▒▒▒░░░░░░▒▒▓▓▓▓▓▓▓▓▓▓▓▓▒▒░░  ░░░░░░░░▓▓██████████████████████████████████░░░░░░░░░░░░░░░░░░░░░░░░░░░░░░██████▓▓▒▒▒▒▒▒▒▒▒▒░░▒▒▒▒▒▒▒▒▒▒▒▒▒▒▒▒▒▒▒▒▒▒▓▓▓▓▓▓▓▓▓▓▒▒▓▒▒
░░░░░░░░░░░░▒▒▒▒▒▒▓▓▓▓▓▓▒▒▒▒▒▒░░░░░░▒▒▒▒▒▒▒▒▒▒▒▒▒▒▒▒░░░░░░    ░░░░░░▒▒▓▓▓▓▓▓▓▓████▓▓▓▓▓▓████████▓▓░░░░▒▒░░░░░░░░░░░░░░░░░░  ░░░░▒▒▓▓▓▓▓▓▓▓▒▒▒▒░░░░░░░░░░░░░░░░░░░░░░▒▒▒▒▒▒▒▒▒▒▒▒▒▒▓▓▓▓▒▒▓▒▒
▓▓▓▓▓▓▒▒▒▒▒▒▒▒▒▒▒▒▓▓▓▓▒▒▒▒▒▒▒▒░░▒▒▒▒▓▓▒▒▒▒▒▒▒▒░░░░▒▒▒▒░░░░▒▒▒▒░░    ░░░░░░▓▓▓▓▓▓▓▓▓▓▓▓▓▓██▓▓▓▓▓▓░░░░▒▒░░░░░░░░░░░░  ░░░░▒▒░░░░░░░░░░▒▒▓▓▓▓▒▒▒▒░░░░░░░░░░░░░░░░░░░░░░░░▒▒▒▒▒▒▒▒▒▒▒▒▒▒▒▒░░▒░░
▓▓▓▓▓▓▓▓▓▓▓▓▓▓▓▓▓▓▓▓▓▓▒▒▒▒▒▒▒▒▒▒▒▒▒▒▒▒▓▓▓▓▒▒▒▒▒▒░░░░░░░░░░▒▒▒▒▒▒▒▒░░    ░░░░▒▒▓▓▓▓▓▓▓▓▓▓▓▓▓▓▓▓░░░░░░░░░░░░░░  ░░░░░░░░░░░░░░░░░░░░░░▒▒▓▓▓▓▓▓▒▒▒▒▒▒░░░░░░░░░░░░░░░░░░░░░░░░░░▒▒▒▒▒▒▒▒▒▒░░▒░░
▒▒▒▒▒▒▒▒▒▒▒▒▒▒▒▒▓▓▓▓▓▓▒▒▒▒▒▒▒▒▒▒▒▒▒▒▒▒▓▓▓▓▓▓░░░░░░░░░░▒▒▒▒░░░░░░░░▒▒▒▒░░    ░░░░▓▓▓▓▓▓▓▓██▓▓▒▒░░░░░░░░  ░░░░░░░░░░░░░░░░░░░░        ░░░░▓▓██▓▓▒▒▒▒▒▒▒▒▒▒▒▒▒▒▒▒▒▒▒▒▓▓▒▒▓▓▒▒▒▒▒▒▓▓▓▓▓▓▒▒░░▒░░
▒▒▒▒▒▒▒▒▒▒▒▒▒▒▒▒▒▒▓▓▓▓▒▒▒▒▒▒▒▒▒▒▒▒▒▒▒▒▒▒▓▓▒▒░░░░░░░░░░░░░░░░░░░░▒▒░░░░░░▒▒░░  ░░░░▓▓▓▓██████░░░░░░░░░░▒▒▒▒▒▒▒▒░░░░▒▒░░░░░░░░░░░░░░░░░░░░▓▓██▓▓▒▒▒▒▒▒▒▒░░░░░░░░░░░░▒▒▒▒▒▒▒▒▒▒▒▒▒▒▓▓▓▓▒▒░░▒░░
░░░░░░░░▒▒▒▒▒▒▒▒▒▒▓▓▒▒▒▒░░░░▒▒▒▒▒▒░░░░░░▒▒▒▒░░░░░░░░░░░░░░░░  ░░░░░░  ░░░░░░░░░░  ░░▒▒▓▓██▒▒░░▒▒▓▓██▒▒▒▒░░▒▒░░▒▒▒▒▒▒░░░░░░░░░░░░░░░░░░░░░░██▒▒▒▒▒▒▒▒▒▒░░░░░░░░░░░░░░░░▒▒▒▒▒▒▒▒▒▒▓▓▒▒▒▒▒▒▒▒▒
░░░░░░░░▒▒▒▒▒▒▒▒▒▒▒▒▒▒▒▒░░░░░░░░░░░░▒▒▒▒▒▒░░░░                        ░░░░  ░░░░░░  ░░▒▒░░▓▓██▒▒░░░░░░▒▒░░░░▒▒▒▒▒▒▒▒▒▒▒▒▒▒░░░░░░░░░░░░░░░░██▓▓▒▒▒▒▒▒▒▒░░    ░░░░░░░░░░░░░░░░░░▒▒▓▓▒▒▒▒▒▒▒▒▒
░░░░░░░░▒▒▒▒▒▒▒▒▒▒▒▒▒▒▒▒▒▒▒▒▒▒▒▒░░░░░░░░░░                                      ░░░░░░▓▓██▒▒░░░░░░▒▒░░░░▒▒▒▒▒▒▒▒▒▒▒▒▒▒▒▒▒▒░░░░▒▒▒▒░░░░░░▓▓██▓▓▓▓▓▓▓▓▓▓▒▒        ░░░░░░░░░░░░░░▒▒▒▒▒▒▒▒▒▒▒▒▒
░░░░░░░░░░▒▒▒▒▓▓▓▓██▓▓▓▓▓▓▒▒▒▒▒▒▒▒▒▒▒▒▒▒░░░░░░  ░░▒▒░░░░░░░░░░░░░░░░░░          ░░▒▒██▒▒░░░░░░░░░░░░▒▒▒▒▒▒▒▒▒▒▒▒▒▒▒▒▒▒▒▒▒▒▒▒░░░░░░░░░░░░▓▓██▓▓▓▓▒▒▒▒▒▒▓▓▓▓▒▒▒▒▒▒▒▒▒▒▒▒▒▒▒▒▓▓▓▓▓▓▒▒░░░░░░░░░
▓▓▓▓▓▓▓▓▓▓▓▓▓▓▓▓▓▓▓▓▒▒▒▒▒▒▒▒▒▒▒▒▒▒▓▓▓▓▓▓▒▒▓▓▒▒░░░░    ░░▓▓▓▓▓▓▓▓▒▒▒▒▒▒▒▒▒▒▒▒░░░░▓▓▓▓░░░░░░░░░░░░▒▒▒▒▒▒▒▒▒▒▒▒▒▒▒▒▒▒▒▒▒▒▒▒▒▒▒▒░░░░░░░░░░░░░░░░▓▓▒▒▒▒▒▒▒▒▒▒▒▒▒▒▒▒▒▒▒▒▒▒▒▒▒▒▒▒▒▒▒▒▓▓▒▒░░░░░░░░░
▒▒▓▓▓▓▓▓▓▓▓▓▒▒▒▒▓▓▓▓▓▓▒▒▒▒▒▒▒▒▒▒▓▓▒▒▒▒▓▓▒▒▓▓▒▒▒▒▒▒░░        ░░▒▒████████▓▓▓▓░░██▒▒░░░░░░░░░░░░░░▒▒▒▒▒▒▓▓▓▓▒▒▒▒▒▒▒▒▒▒▒▒▒▒▒▒▒▒░░░░░░▓▓▓▓▓▓▓▓▒▒▒▒▒▒▒▒▒▒▒▒▒▒░░░░░░░░░░░░░░▒▒▒▒▒▒▒▒▒▒▒▒▓▓▒▒▒▒▒▒▒
▒▒▓▓▓▓▓▓▓▓▓▓▒▒▒▒▒▒▓▓▓▓▒▒▒▒▒▒▒▒▓▓▓▓▓▓▓▓▓▓▓▓▓▓▒▒▒▒▒▒▒▒░░░░            ▒▒▓▓██░░██░░░░░░░░░░░░░░▒▒▒▒▒▒▒▒▓▓▓▓██████████▓▓▓▓▓▓▒▒▒▒▒▒░░░░░░████▓▓▓▓▓▓▒▒▒▒▒▒▒▒░░░░░░░░░░░░░░░░░░▒▒▒▒▒▒▒▒▓▓▓▓▓▓▓▓▓▓▓
▒▒▒▒▓▓▓▓▓▓▒▒▒▒▒▒▒▒▓▓▓▓▒▒▒▒▒▒▒▒▒▒░░▒▒▒▒▓▓██████▓▓▒▒▒▒▒▒░░░░              ░░▓▓▒▒░░░░░░░░░░▒▒▒▒██████████▓▓▓▓▓▓██████▓▓██▓▓▓▓▓▓▓▓▒▒░░░░▓▓██▓▓▓▓██▓▓▒▒▒▒░░░░░░░░░░░░░░░░░░░░░░▒▒▒▒▒▒▓▓▓▓▓▓██▓██
▒▒▒▒▓▓▓▓▒▒▒▒▒▒▒▒▒▒▒▒▒▒▒▒▒▒░░░░░░▒▒░░░░▒▒▒▒▓▓▓▓██████▓▓▒▒░░░░            ▒▒▒▒░░░░░░░░▒▒▓▓██▓▓▒▒▒▒▒▒▒▒▒▒▒▒▒▒▒▒▒▒▒▒▓▓▒▒▒▒▒▒▓▓▓▓▓▓▒▒▒▒░░░░██▓▓████▓▓▓▓▓▓▓▓▒▒░░░░░░░░░░░░░░░░░░░░░░▒▒▒▒▒▒▒▒▒▒▒▒▒
░░▒▒▒▒▒▒▒▒▒▒▒▒▒▒▒▒▓▓▓▓▒▒▒▒▒▒▒▒▒▒▒▒▒▒▒▒▒▒▒▒▒▒▒▒▒▒▒▒▒▒▒▒▒▒▓▓▒▒░░        ░░▓▓░░░░░░░░▓▓▓▓░░▒▒▒▒▒▒░░░░░░░░▒▒▒▒▒▒▒▒▓▓▓▓▓▓▓▓▓▓▓▓▓▓▓▓▓▓▒▒▒▒░░▒▒▓▓██▓▓▒▒▒▒▒▒▓▓▓▓▓▓▒▒░░░░░░░░░░░░░░░░▒▒▒▒▓▓▒▒▒▒▒▒▒▒▒
░░▒▒▒▒▓▓▓▓▓▓▓▓▓▓▓▓▒▒▒▒▒▒▒▒▒▒▒▒▓▓▓▓▓▓▓▓▓▓▓▓▓▓▓▓▓▓▓▓▓▓▓▓▒▒░░░░▒▒░░      ░░░░░░░░░░▓▓░░▒▒░░▒▒▓▓▓▓▓▓▓▓▓▓▓▓▓▓▓▓▓▓▒▒▒▒▒▒▒▒▒▒▒▒▒▒▒▒▓▓▒▒▒▒░░░░  ▒▒▓▓▓▓▒▒▒▒▒▒▒▒▒▒▒▒▒▒▒▒▒▒▒▒▒▒▒▒▓▓▓▓▓▓▓▓▓▓████▓▓▒▒▓▒▒
░░▒▒▓▓▓▓▓▓▓▓▓▓▓▓▒▒▒▒▒▒▒▒▒▒▒▒░░░░░░░░░░░░░░░░░░░░░░░░░░░░░░▒▒▒▒░░▒▒    ░░░░░░▒▒░░░░▒▒▓▓▓▓████████████████████▓▓▓▓▓▓▓▓▓▓▒▒▒▒▒▒▒▒▒▒▒▒░░░░░░▒▒░░░░░░░░▒▒▒▒▒▒▒▒░░░░▒▒▒▒▒▒▒▒▒▒▒▒▒▒▒▒▓▓▓▓█████████
████▓▓▓▓▓▓▓▓▒▒▒▒░░░░░░░░░░░░░░░░░░░░░░░░░░░░░░░░░░░░░░░░░░░░░░░░░░░░  ░░░░░░░░▒▒▓▓▓▓▓▓▓▓▒▒▒▒░░░░▒▒▒▒▒▒▒▒▒▒▒▒▒▒▒▒▒▒▒▒▒▒▓▓▓▓▓▓▓▓▓▓▒▒░░░░▒▒▒▒░░░░░░░░░░░░▒▒▒▒░░░░░░░░░░▒▒▒▒▒▒▒▒▒▒▓▓▓▓▓▓███████
▒▒▒▒▓▓▓▓▓▓▒▒▒▒░░░░░░░░░░░░░░░░░░░░░░░░░░░░░░░░░░░░░░░░░░░░░░░░░░░░░░░░░░░░░░▓▓▓▓▓▓████████████████████████████████▒▒▒▒▒▒▒▒▒▒▒▒▒▒▓▓▓▓▓▓▒▒                ░░░░░░░░░░░░░░░░▒▒▒▒▒▒▒▒▓▓▓▓▓▓▓▓▓▓▓
▒▒▒▒▓▓▒▒▒▒▒▒▒▒░░░░░░░░░░░░░░░░░░░░░░░░░░░░░░░░░░░░░░░░░░░░░░░░░░░░░░▓▓████▓▓██████████████████████████████▓▓▒▒  ▒▒▒▒▒▒▒▒▒▒▒▒▒▒▒▒▒▒▒▒▒▒▒▒▒▒▒▒░░░░░░              ░░░░░░░░░░░░░░▒▒▒▒▓▓▓▓▒▒▓▒▒
▒▒▒▒▒▒▒▒▒▒▒▒░░░░░░░░░░░░░░░░░░░░░░░░░░░░░░░░░░░░░░░░░░░░░░░░░░░░░░▒▒██████▓▓██████████████████████████▓▓▒▒░░  ▒▒▒▒▒▒▒▒▒▒▒▒▒▒▓▓▓▓▓▓▓▓▓▓▓▓▓▓▓▓▒▒▒▒▒▒▒▒▒▒▒▒░░░░        ░░▒▒▒▒▒▒▓▓▓▓▓▓██▓▓▓▓▓▓▓
▒▒▒▒▒▒▓▓▓▓▒▒▒▒▒▒▒▒░░░░░░░░░░░░░░░░░░░░░░░░▒▒░░░░░░░░░░░░░░░░░░░░░░██████████████████████████████████▓▓▒▒  ░░▒▒▒▒▒▒▒▒▒▒▒▒▓▓▓▓▓▓▓▓▓▓▓▓▓▓▓▓▓▓▓▓▓▓▓▓▓▓▓▓▓▓▓▓▒▒▒▒▒▒▒▒▒▒▒▒░░░░░░▒▒▒▒▓▓▓▓▓▓▓▓▓▓▓▓▓
▒▒▒▒▒▒▓▓▓▓▓▓▓▓▓▓▓▓▓▓████████████████████████▓▓▓▓████████▓▓▓▓▓▓▓▓██▓▓██▓▓████████▓▓▓▓▒▒▒▒░░░░░░░░░░▒▒▓▓░░  ▒▒▒▒░░▒▒▓▓▓▓██████▓▓▓▓██████████████████▓▓▓▓▓▓▓▓▓▓▓▓▓▓▓▓▓▓▒▒▒▒▒▒▒▒▒▒▒▒▓▓▓▓▓▓▓▓▓▓▓
▒▒▒▒▓▓▓▓▓▓▓▓▓▓▓▓████████                  ░░  ░░░░  ░░░░░░░░░░▒▒▒▒▒▒▒▒▒▒░░░░                            ░░▒▒░░▓▓▓▓▒▒▒▒░░░░░░░░░░░░░░░░░░▒▒▒▒▒▒▒▒▒▒▒▒▓▓▓▓████████████▓▓▓▓▓▓▓▓▓▓▓▓▒▒▓▓▓▓▓▓▓▓▓
▓▓▓▓▓▓▓▓▓▓▓▓██████████                                                              ░░░░▒▒▒▒▒▒░░░░░░░░░░░░░░▒▒░░░░░░░░░░░░░░░░░░░░░░░░░░░░▒▒▒▒▒▒▒▒▒▒▒▒▒▒▒▒▒▒▒▒▒▒▒▒▒▒▒▒▒▒▓▓▓▓▓▓▓▓▓▓▒▒▒▒▓▓▒▓▓
▒▒▒▒▒▒▒▒▒▒▒▒▒▒▒▒▒▒▒▒░░                                                ░░░░░░░░░░░░░░░░░░░░░░░░░░░░░░▒▒▒▒▒▒▒▒░░░░░░░░░░░░░░░░░░░░░░░░░░░░░░░░░░░░▒▒▒▒▒▒▒▒▒▒▒▒▒▒▒▒▒▒▒▒▒▒▒▒▒▒▒▒▒▒▒▒▒▒▒▒▒▒▒▒▒▒▒
▒▒▒▒▒▒▒▒▒▒▒▒▒▒▒▒▒▒▒▒  ░░░░░░░░░░  ░░░░░░░░░░░░░░░░░░▒▒▒▒▒▒▒▒▒▒░░░░░░░░░░░░░░░░░░░░░░░░░░░░░░░░░░░░░░▒▒██████▒▒░░░░▒▒▒▒▓▓▓▓▓▓██████████▒▒▒▒▒▒▒▒▒▒░░░░░░░░░░░░░░░░░░░░░░░░▒▒▒▒▒▒▒▒▒▒▒▒▒▒░░▒░░




                       ▀█▀ █ █ █▀▀   █▀▀ ▀█▀ █▀▀ █ █ █▀▄ █▀▀   █   █▀▀ █▀█ █▀▄ █▀▀   █ █ █▀█ █ █   ▀█▀ █▀█   █▀█   █▀▄ █▀█ █▀█ █▄█   █▀▀ █ █ █   █     █▀█ █▀▀
                        █  █▀█ █▀▀   █▀▀  █  █ █ █ █ █▀▄ █▀▀   █   █▀▀ █▀█ █ █ ▀▀█    █  █ █ █ █    █  █ █   █▀█   █▀▄ █ █ █ █ █ █   █▀▀ █ █ █   █     █ █ █▀▀
                        ▀  ▀ ▀ ▀▀▀   ▀   ▀▀▀ ▀▀▀ ▀▀▀ ▀ ▀ ▀▀▀   ▀▀▀ ▀▀▀ ▀ ▀ ▀▀  ▀▀▀    ▀  ▀▀▀ ▀▀▀    ▀  ▀▀▀   ▀ ▀   ▀ ▀ ▀▀▀ ▀▀▀ ▀ ▀   ▀   ▀▀▀ ▀▀▀ ▀▀▀   ▀▀▀ ▀
                       █▀█ █   █▀▄   █▀▄ █▀█ █▀█ █ █ █▀▀      ▀█▀ █ █ █▀▀   █ █ █▀█ █   █   █▀▀   █▀▀ █ █ █▀█ █ █   █▀█ ▀█▀ █▀▀ ▀█▀ █ █ █▀▄ █▀▀ █▀▀   █▀█ █▀▀
                       █ █ █   █ █   █▀▄ █ █ █ █ █▀▄ ▀▀█       █  █▀█ █▀▀   █▄█ █▀█ █   █   ▀▀█   ▀▀█ █▀█ █ █ █▄█   █▀▀  █  █    █  █ █ █▀▄ █▀▀ ▀▀█   █ █ █▀▀
                       ▀▀▀ ▀▀▀ ▀▀    ▀▀  ▀▀▀ ▀▀▀ ▀ ▀ ▀▀▀ ▀     ▀  ▀ ▀ ▀▀▀   ▀ ▀ ▀ ▀ ▀▀▀ ▀▀▀ ▀▀▀   ▀▀▀ ▀ ▀ ▀▀▀ ▀ ▀   ▀   ▀▀▀ ▀▀▀  ▀  ▀▀▀ ▀ ▀ ▀▀▀ ▀▀▀   ▀▀▀ ▀
                            █▀▄ █▀█ █▀▄ █ █   █▄█ █▀█ █▀▀ ▀█▀ █▀▀      █ █ █▀█ █ █   █▀▄ █▀▀ █▀█ █   ▀█▀ ▀▀█ █▀▀   ▀█▀ █ █ █▀▀   █▀▀ ▀█▀ █▀▀ █ █ █▀▄ █▀▀
                            █ █ █▀█ █▀▄ █▀▄   █ █ █▀█ █ █  █  █         █  █ █ █ █   █▀▄ █▀▀ █▀█ █    █  ▄▀  █▀▀    █  █▀█ █▀▀   █▀▀  █  █ █ █ █ █▀▄ █▀▀
                            ▀▀  ▀ ▀ ▀ ▀ ▀ ▀   ▀ ▀ ▀ ▀ ▀▀▀ ▀▀▀ ▀▀▀ ▀     ▀  ▀▀▀ ▀▀▀   ▀ ▀ ▀▀▀ ▀ ▀ ▀▀▀ ▀▀▀ ▀▀▀ ▀▀▀    ▀  ▀ ▀ ▀▀▀   ▀   ▀▀▀ ▀▀▀ ▀▀▀ ▀ ▀ ▀▀▀
                      █ █ █▀█ █▀▀   █▀█ █   █▀▀ █▀█   ▀█▀ █▀▄ █▀█ █▀█ █▀█ █▀▀ █▀▄   █ █ █▀▀ █▀▄ █▀▀       ▀▀█ █ █ █▀▀ ▀█▀   █   ▀█▀ █ █ █▀▀   █ █ █▀█ █ █
                      █▄█ █▀█ ▀▀█   █▀█ █   ▀▀█ █ █    █  █▀▄ █▀█ █▀▀ █▀▀ █▀▀ █ █   █▀█ █▀▀ █▀▄ █▀▀         █ █ █ ▀▀█  █    █    █  █▀▄ █▀▀    █  █ █ █ █
                      ▀ ▀ ▀ ▀ ▀▀▀   ▀ ▀ ▀▀▀ ▀▀▀ ▀▀▀    ▀  ▀ ▀ ▀ ▀ ▀   ▀   ▀▀▀ ▀▀    ▀ ▀ ▀▀▀ ▀ ▀ ▀▀▀ ▄▀    ▀▀  ▀▀▀ ▀▀▀  ▀    ▀▀▀ ▀▀▀ ▀ ▀ ▀▀▀    ▀  ▀▀▀ ▀▀▀ ▀  ▀  ▀
