            ████▓▓▓▓▓▓▓▓▓▓▒▒▒▒░░░░░░░░░░░░░░░░░░░░  ░░░░░░  ░░░░░░░░░░░░░░░░░░░░  ░░░░░░░░░░░░░░░░▒▒▒▒▒▒▒▒░░░░░░░░░░░░░░▒▒░░▒▒▒▒▒▒▒▒▒▒▒▒▒▒▒▒▒▒▓▓▓▓▓▓▓▓▓▓▓▓▓▓████████████████████
            ▓▓████▓▓▓▓▓▓▓▓▓▓▒▒▒▒░░░░░░░░░░░░░░░░░░░░░░░░░░      ░░░░░░░░░░░░░░░░░░░░░░░░░░░░░░░░░░░░▒▒▒▒░░░░░░░░░░░░░░▒▒░░▒▒▒▒▒▒▒▒▒▒▒▒▒▒▒▒▒▒▒▒▓▓▓▓▓▓▓▓▓▓▓▓██████████████████████
            ▓▓████▓▓▓▓▓▓▓▓▓▓▓▓▒▒▒▒▒▒░░░░░░░░░░░░░░░░░░░░░░  ░░░░░░░░░░░░░░░░░░░░░░░░░░░░░░░░░░░░░░░░▒▒▒▒░░▒▒░░░░░░▒▒▒▒▒▒▒▒▒▒▒▒▒▒▒▒▒▒▒▒▒▒▒▒▒▒▒▒▓▓▓▓▓▓▓▓▓▓▓▓▓▓████████████████████
            ██▓▓██▓▓██▓▓▓▓▓▓▓▓▒▒▒▒▒▒░░░░░░░░░░░░░░░░░░░░░░░░░░░░░░░░░░░░░░░░░░░░░░░░▒▒▒▒░░░░░░░░░░░░▒▒▒▒░░▒▒▒▒▒▒▒▒▒▒▒▒▒▒▒▒▒▒▒▒▒▒▒▒▒▒▒▒▒▒▒▒▒▒▓▓▓▓▓▓▓▓▓▓▓▓▓▓▓▓▓▓██████████████████
            ▓▓████████▓▓▓▓▓▓▓▓▒▒▒▒▒▒░░░░░░░░░░░░░░░░░░░░░░░░░░░░░░░░░░░░░░░░▒▒▒▒▒▒▒▒▒▒▒▒▒▒▒▒░░░░░░░░▒▒▒▒░░▒▒▒▒▒▒▒▒▒▒▒▒▒▒▒▒▒▒▒▒▒▒▒▒▒▒▒▒▒▒▒▒▒▒▓▓▓▓▓▓▓▓▓▓▓▓▓▓▓▓▓▓██████████████████
            ░░▓▓██▓▓████▓▓▓▓▒▒▓▓▒▒▒▒▒▒░░░░░░░░░░░░░░░░░░░░░░░░░░░░░░░░░░░░░░▒▒▒▒▒▒▒▒▒▒▒▒▒▒▒▒░░░░░░▒▒░░░░░░▒▒▒▒▒▒▒▒▒▒▒▒▒▒▒▒▒▒▒▒▒▒▒▒▒▒▒▒▒▒▒▒▒▒▓▓▓▓▓▓▓▓▓▓▓▓▓▓▓▓████████████████████
            ▓▓▓▓▓▓▓▓████▓▓▓▓▒▒▓▓▓▓▒▒▒▒▒▒▒▒▒▒▒▒▒▒░░░░░░░░░░░░░░░░░░░░░░░░▒▒▒▒▒▒▒▒▒▒▒▒▒▒▒▒░░░░░░░░░░░░░░▒▒▒▒▒▒░░░░▒▒▒▒▒▒▒▒▒▒▒▒▒▒▒▒▒▒▒▒▒▒▒▒▒▒▓▓▓▓▓▓▓▓▓▓▓▓▓▓▓▓▓▓▓▓██████████████████
            ▓▓▓▓▓▓▓▓▓▓██▓▓▓▓▓▓▓▓▓▓▓▓▒▒▓▓▓▓▒▒▒▒▒▒▒▒▒▒░░░░░░░░░░░░░░░░░░▒▒▒▒▒▒▒▒▒▒▒▒▒▒▒▒░░░░░░░░░░░░░░▒▒▒▒▒▒▒▒░░░░░░░░▒▒▒▒▒▒▒▒▒▒▒▒▒▒▒▒▒▒▒▒▒▒▒▒▓▓▓▓▓▓▓▓▓▓▓▓▓▓▓▓▓▓▓▓▓▓██████████████
            ▓▓▓▓▓▓▓▓▓▓██▓▓▓▓▓▓▓▓▓▓▓▓▓▓▓▓▓▓▓▓▒▒▒▒▒▒▒▒▒▒░░░░░░░░░░▒▒▒▒▒▒▒▒▒▒▒▒▒▒▒▒▒▒▒▒▒▒░░░░░░░░░░░░░░░░▒▒▒▒▒▒░░░░░░▒▒▒▒▒▒▒▒▒▒▒▒▒▒▒▒▒▒▒▒▒▒▒▒▒▒▓▓▓▓▓▓▒▒▓▓▓▓▓▓▓▓▓▓▓▓▓▓▓▓▓▓▓▓████████
            ████▓▓▓▓██▓▓▓▓▓▓▓▓▓▓▓▓▒▒▓▓▓▓▓▓▓▓▓▓▒▒▒▒▒▒▒▒░░░░░░▒▒░░▒▒▒▒▒▒▒▒▒▒░░▒▒▒▒▒▒▒▒▒▒░░░░░░░░░░░░░░▒▒▒▒▒▒▒▒░░░░░░▒▒▒▒▒▒▒▒▒▒▒▒▒▒▒▒▒▒▒▒▒▒▒▒▒▒▒▒▒▒▒▒▒▒▓▓▓▓▓▓▓▓▓▓▓▓▓▓▓▓▓▓▓▓▓▓██████
            ▓▓▓▓▓▓▓▓▓▓██▓▓▓▓▓▓▓▓▓▓▓▓▓▓▓▓▓▓▓▓▒▒▒▒▒▒▒▒▒▒▒▒  ▒▒▒▒░░▒▒▒▒░░▒▒░░▒▒▒▒▒▒▒▒▒▒▒▒▒▒░░░░░░░░░░░░▒▒░░░░░░░░░░░░▒▒░░▒▒▒▒▒▒▒▒▒▒▒▒▒▒▒▒▒▒▒▒▒▒▒▒▒▒▒▒▒▒▒▒▓▓▓▓▓▓▓▓▓▓▓▓▓▓▓▓▓▓▓▓██████
            ▓▓▓▓▓▓▓▓▓▓▓▓▓▓▓▓▓▓▓▓▓▓▓▓▓▓▓▓▓▓▓▓▒▒▒▒▒▒▒▒▒▒▒▒▒▒▒▒▒▒░░▒▒▒▒▒▒▒▒▒▒▒▒▒▒▒▒▒▒▒▒▒▒▒▒░░░░░░░░░░░░░░░░░░░░▒▒▒▒▒▒▒▒▒▒▒▒▒▒▒▒░░▒▒▒▒▒▒░░░░▒▒▒▒▒▒▒▒▒▒▒▒▒▒▓▓▓▓▓▓▓▓▓▓▓▓▓▓▓▓▓▓▓▓██████
            ▓▓▓▓▓▓▓▓▓▓▓▓▓▓▓▓▓▓▓▓▓▓▓▓▓▓▓▓▓▓▓▓▓▓▓▓▒▒▒▒▓▓▒▒▒▒▒▒▒▒▒▒░░▒▒▒▒▒▒▒▒▒▒▒▒▒▒▒▒▒▒▒▒▒▒░░░░░░░░░░░░░░░░▒▒░░▒▒▒▒▒▒▒▒▒▒▒▒▒▒▒▒▒▒▒▒▒▒▒▒░░░░▒▒▒▒▒▒▒▒▒▒░░▒▒▒▒▒▒▓▓▓▓▓▓▓▓▓▓▓▓▓▓▓▓██████
            ▓▓▓▓▓▓▓▓▓▓▓▓▓▓▓▓██▓▓██▓▓▓▓▓▓▓▓▓▓▓▓▓▓▓▓▓▓▒▒▒▒▒▒▒▒▒▒▒▒░░▒▒▒▒▒▒▒▒▒▒▒▒▒▒▒▒▒▒▒▒▒▒░░░░░░░░░░░░░░░░▒▒▒▒▒▒▒▒▒▒░░▒▒░░▒▒▒▒▒▒▒▒▒▒▒▒░░░░▒▒▒▒▒▒▒▒▒▒▒▒▒▒▒▒▒▒▓▓▓▓▓▓▓▓▓▓▓▓▓▓████████
            ▓▓▓▓▓▓▓▓▓▓▓▓▓▓▓▓▓▓████▓▓▓▓▓▓▓▓▓▓██▓▓▓▓▓▓▓▓▓▓▒▒▒▒▒▒▒▒▒▒▒▒▒▒▒▒▒▒▒▒▒▒▒▒▒▒▒▒▒▒▒▒▒▒▒▒░░░░░░░░░░░░▒▒░░▒▒▒▒▒▒▒▒▒▒▒▒░░▒▒▒▒░░░░▒▒░░░░▒▒▒▒▒▒▓▓▒▒▒▒▒▒▒▒▓▓▓▓▓▓▓▓▓▓▓▓▓▓▓▓████████
            ▓▓████▓▓▓▓▓▓▓▓▓▓▓▓▓▓▓▓▓▓▓▓▓▓████▓▓▓▓▓▓▓▓▓▓▓▓▒▒▒▒▒▒▒▒▒▒▒▒▒▒▒▒▒▒▒▒▒▒▒▒▒▒▒▒▒▒▒▒▒▒▒▒░░░░░░░░░░░░░░░░░░▒▒▒▒▒▒▒▒▒▒▒▒▒▒▒▒▒▒▒▒▒▒▒▒▒▒▒▒▓▓▓▓▓▓▓▓▓▓▓▓▓▓▓▓▓▓▓▓▓▓▓▓▓▓▓▓▓▓████████
            ██████▓▓▓▓██▓▓████▓▓██▓▓████▓▓▓▓████▓▓▓▓▓▓▓▓▓▓▓▓▓▓▓▓▒▒▒▒▒▒▒▒▒▒▒▒▒▒▒▒▒▒▒▒▒▒▒▒▒▒▒▒▒▒▒▒░░░░░░░░░░░░▒▒▒▒▒▒▒▒▒▒▒▒▒▒▒▒▒▒▒▒▒▒▒▒▒▒▒▒▓▓▓▓▓▓▓▓▓▓▓▓▓▓▓▓▓▓▓▓▓▓▓▓▓▓▓▓▓▓██████████
            ▓▓▓▓██▓▓▓▓██▓▓▓▓██▓▓▓▓██▓▓████████████▓▓▓▓▓▓▓▓▓▓▓▓▓▓▓▓▒▒▓▓▒▒▒▒▒▒▒▒▒▒▒▒▒▒▒▒▒▒▒▒▒▒▒▒░░░░░░░░░░░░░░▒▒▒▒▒▒▒▒▒▒▒▒▒▒▒▒▒▒▒▒▒▒▒▒▒▒▓▓▓▓▓▓▓▓▓▓▓▓▓▓▓▓▓▓▓▓▓▓████████████████████
            ▓▓▓▓▓▓▓▓▓▓████████▓▓████████████████████▓▓▓▓▓▓▓▓▓▓▓▓▒▒▒▒▒▒▒▒▓▓▒▒▒▒▒▒▒▒▒▒▒▒▒▒▒▒▒▒▒▒░░░░░░░░░░  ░░▒▒▒▒▒▒▒▒▒▒▒▒▒▒▒▒▒▒▒▒▒▒▓▓▒▒▓▓▓▓▓▓▓▓▓▓▓▓▓▓▓▓▓▓▓▓▓▓████████████████████
            ▓▓▓▓██████▓▓██████▓▓████████████████████████▓▓▓▓▓▓▓▓▓▓▓▓▒▒▒▒▓▓▓▓▒▒▒▒▒▒▒▒▒▒▒▒▒▒▒▒▒▒░░░░░░░░░░░░░░░░▒▒▒▒▒▒▒▒▒▒▒▒▒▒▓▓▓▓▓▓▓▓▒▒▓▓▓▓▓▓▓▓▓▓▓▓██████████████████████████████
            ▓▓▓▓████████████████████████████████████████▓▓▓▓▓▓▓▓▓▓▓▓▓▓▓▓▓▓▓▓▓▓▒▒▒▒▒▒▒▒▒▒░░▒▒░░░░░░░░░░░░░░░░░░░░▒▒▒▒▒▒▓▓▓▓▓▓▓▓▓▓▓▓▒▒▓▓▓▓▓▓▓▓▓▓▓▓████████████████████████████████
            ▓▓████████████████▓▓████████████████████████▓▓▓▓▓▓▓▓▓▓▓▓▓▓▓▓▓▓▓▓▓▓▒▒▒▒▒▒▒▒░░░░░░░░░░░░░░░░░░░░░░▒▒▒▒▒▒▒▒▓▓▓▓▓▓▓▓▓▓▓▓▓▓▓▓▓▓▓▓▓▓▓▓▓▓▓▓▓▓██████████████████████████████
            ▓▓██████████████████████████████████████████▓▓▓▓▓▓▓▓▓▓▓▓▓▓▓▓▓▓▓▓▓▓▓▓▒▒▒▒▒▒░░▒▒▒▒▒▒▒▒▒▒▒▒░░░░░░▒▒▒▒▒▒▓▓▓▓▒▒▒▒▒▒▓▓▓▓▓▓▓▓▓▓▓▓▓▓▓▓▓▓▓▓▓▓▓▓▓▓████████████████████████████
            ████████████████████████████████████████████▓▓▓▓▓▓▓▓▓▓▓▓▓▓▓▓▓▓▓▓▓▓▓▓▓▓▒▒▒▒░░▒▒▒▒▒▒▒▒▒▒░░░░░░░░▒▒▒▒░░    ░░░░░░▒▒▒▒▒▒▒▒▒▒▓▓▓▓██████████████▓▓████████████████████████
            ██████████████████████████████████████████████████▓▓▓▓▓▓▓▓▓▓▓▓▒▒░░      ░░░░░░░░░░░░░░░░▒▒░░░░░░          ░░░░░░▒▒▒▒▒▒▒▒▒▒▒▒▒▒▓▓▓▓▓▓████████████████████████████████
            ██████████████████████████████████████████████▓▓▒▒▒▒░░                ░░░░░░░░░░░░░░░░░░░░░░░░▒▒        ░░░░░░░░▒▒▒▒▒▒▒▒▒▒▒▒▒▒▒▒▒▒▒▒▒▒▒▒▓▓██████████████████████████
            ████████████████████████████████████████████░░                      ░░░░░░▒▒▒▒▒▒░░░░░░░░░░░░▒▒▒▒            ░░░░▒▒▒▒▒▒▒▒▒▒▒▒▒▒▒▒▒▒▒▒▒▒▒▒▒▒▓▓████████████████████████
            ████████████████████████████████████████▓▓                        ░░░░░░░░▒▒░░▒▒░░░░░░░░░░░░▒▒▒▒    ░░▒▒▒▒▒▒▒▒░░░░░░▒▒▒▒▒▒▒▒▒▒▒▒▒▒▒▒▒▒▒▒▒▒▒▒▒▒██████████████████████
            ██████████████████████████████████████░░░░            ░░░░▒▒▒▒▒▒▒▒▒▒▒▒▒▒▒▒▒▒▒▒▒▒░░░░░░░░░░░░▒▒▒▒  ▒▒▒▒▒▒▒▒░░▒▒▒▒▒▒▒▒▒▒▒▒▒▒░░░░░░░░▒▒▒▒▒▒▒▒▒▒▒▒▒▒▓▓▓▓████████████████
            ▓▓▓▓▓▓▓▓▓▓▓▓▓▓▓▓▓▓▓▓▓▓▓▓▓▓▓▓▓▓▓▓▓▓▒▒░░░░░░░░▒▒▒▒▒▒▒▒▒▒▒▒▒▒▓▓▓▓▒▒▒▒▒▒▒▒▒▒▒▒▒▒▒▒▒▒▒▒▒▒░░░░░░▒▒▒▒▒▒▒▒░░▒▒▒▒▒▒▒▒▒▒▒▒░░▒▒▒▒▒▒░░▒▒▒▒▒▒▒▒▒▒░░░░░░▒▒▒▒▒▒▒▒▓▓████████████████
            ▓▓▓▓▓▓▓▓▓▓▓▓▓▓▓▓▓▓▓▓▓▓▒▒▒▒▒▒▒▒▒▒▒▒▒▒▒▒▒▒▒▒▒▒▒▒▒▒▒▒▒▒▒▒░░░░░░░░░░░░░░░░░░░░░░░░░░░░▒▒░░░░░░▒▒▒▒▒▒░░▒▒▒▒▒▒▒▒▒▒▒▒▒▒▒▒▒▒░░░░▒▒░░▒▒▒▒▒▒░░▒▒▒▒▒▒▒▒▒▒░░▒▒▒▒▒▒██████████████
            ▓▓▓▓▓▓▓▓▓▓▓▓▓▓▓▓▓▓▓▓▒▒▒▒▒▒▒▒▒▒▒▒▒▒▒▒▒▒▒▒▒▒▒▒▒▒▒▒▒▒▒▒▒▒░░░░░░░░░░░░░░░░░░░░░░░░░░░░░░░░░░░░░░░░░░░░░░░░░░░░░░░░░░░░░░░░░░▒▒▒▒▒▒▒▒▒▒▒▒▒▒▒▒▒▒▒▒▒▒▒▒▒▒▒▒▒▒▒▒▓▓██████████
            ▓▓▓▓▓▓▓▓▓▓▓▓▓▓▓▓▓▓▒▒▒▒▒▒▒▒▒▒▒▒▒▒▒▒▒▒▒▒▒▒▒▒▒▒▒▒▒▒▒▒▒▒▒▒░░░░░░░░░░░░░░░░░░░░░░░░░░░░░░░░░░░░░░░░░░░░░░░░░░░░▒▒▒▒▒▒▒▒▒▒▒▒▒▒▒▒▒▒▒▒▒▒▒▒▒▒▒▒▒▒▒▒▒▒▒▒▒▒▒▒▒▒▒▒▒▒▒▒▒▒████████
            ▒▒▓▓▓▓▓▓▓▓▓▓▒▒▒▒▒▒▒▒▒▒▓▓▒▒▒▒▒▒▒▒▒▒▒▒▒▒▒▒▒▒▒▒▒▒▒▒▒▒▒▒▒▒▒▒░░░░░░░░▒▒▒▒▒▒▒▒░░░░░░░░░░░░░░░░░░░░░░░░░░░░░░▒▒▒▒▒▒▓▓▓▓▓▓▓▓▓▓████████▓▓▓▓▒▒▒▒▒▒▒▒▒▒▒▒▒▒▒▒▒▒▒▒▒▒▒▒▒▒▒▒▓▓████
            ▓▓▓▓▓▓▓▓▒▒▓▓▓▓▓▓▒▒▓▓▓▓▓▓▒▒▒▒▒▒▒▒▒▒▒▒▒▒▒▒▒▒▒▒▒▒▒▒▒▒▒▒▓▓▓▓▓▓▓▓▓▓▓▓▓▓▓▓▓▓▓▓▓▓▓▓▓▓▓▓▒▒░░░░░░░░▒▒▒▒░░░░░░▒▒▓▓▓▓▓▓▓▓▓▓▓▓▓▓▓▓▓▓▓▓▓▓▓▓▓▓▓▓▓▓▓▓▓▓██▓▓▓▓▓▓▒▒▒▒▒▒▒▒▒▒▒▒▒▒▒▒▓▓██
            ▓▓██▓▓▓▓▓▓▓▓▓▓▓▓▓▓▓▓▒▒▒▒▒▒▒▒▒▒▒▒▒▒▒▒▒▒▓▓▓▓▓▓▓▓▓▓▓▓████████████████▓▓██████████████▒▒▒▒▓▓▓▓▓▓▓▓▓▓▓▓▒▒████████████████████████████████████████████████████████▓▓▓▓▓▓██
            ▓▓▓▓▓▓▓▓▓▓▓▓▓▓▓▓██████████████████████████████████████████████████████████████████████████▓▓▓▓▓▓▓▓██████████████████████████████████████████████████████████████████




                          █▀▄ █▀▀ █▀▀ █▀█   █▀▄ █▀▀ █   █▀█ █ █       █ █ █▀█ █ █   █▀▀ ▀█▀ █▀█ █▀▄   █▀█   █▀▀ ▀█▀ █▀█ █▀█ █▀▀   ▀█▀ █▀█ █▀▄ █   █▀▀
                          █ █ █▀▀ █▀▀ █▀▀   █▀▄ █▀▀ █   █ █ █▄█        █  █ █ █ █   █▀▀  █  █ █ █ █   █▀█   ▀▀█  █  █ █ █ █ █▀▀    █  █▀█ █▀▄ █   █▀▀
                          ▀▀  ▀▀▀ ▀▀▀ ▀     ▀▀  ▀▀▀ ▀▀▀ ▀▀▀ ▀ ▀ ▄▀     ▀  ▀▀▀ ▀▀▀   ▀   ▀▀▀ ▀ ▀ ▀▀    ▀ ▀   ▀▀▀  ▀  ▀▀▀ ▀ ▀ ▀▀▀    ▀  ▀ ▀ ▀▀  ▀▀▀ ▀▀▀ ▀
                       ▀█▀ █ █ █▀▀   █▀▀ ▀█▀ █▀▀ █ █ █▀▄ █▀▀  █▀▀ █ █ █▀█ █ █ █▀▀   █ █ █▀█ █ █   █ █ █ █ █▀█ ▀█▀ ▀ █▀▀   █ █ █▀▄ ▀█▀ ▀█▀ ▀█▀ █▀▀ █▀█   █▀█ █▀█
                        █  █▀█ █▀▀   █▀▀  █  █ █ █ █ █▀▄ █▀▀  ▀▀█ █▀█ █ █ █▄█ ▀▀█    █  █ █ █ █   █▄█ █▀█ █▀█  █    ▀▀█   █▄█ █▀▄  █   █   █  █▀▀ █ █   █ █ █ █
                        ▀  ▀ ▀ ▀▀▀   ▀   ▀▀▀ ▀▀▀ ▀▀▀ ▀ ▀ ▀▀▀  ▀▀▀ ▀ ▀ ▀▀▀ ▀ ▀ ▀▀▀    ▀  ▀▀▀ ▀▀▀   ▀ ▀ ▀ ▀ ▀ ▀  ▀    ▀▀▀   ▀ ▀ ▀ ▀ ▀▀▀  ▀   ▀  ▀▀▀ ▀ ▀   ▀▀▀ ▀ ▀
              ▀█▀ ▀█▀         ▀█▀ ▀█▀   ▀█▀ █▀▀ █   █   █▀▀   █▀█ █▀▀   █▀█ █▀█   █▀▀ █ █ ▀█▀ █     █▀▀ █▀█ █▀▀ █   █      ▀█▀ █▀█   █▀▄ █▀▄ █▀▀ █▀█ █ █   █▀▀ █▀▄ █▀▀ █▀▀
               █   █           █   █     █  █▀▀ █   █   ▀▀█   █ █ █▀▀   █▀█ █ █   █▀▀ ▀▄▀  █  █     ▀▀█ █▀▀ █▀▀ █   █       █  █ █   █▀▄ █▀▄ █▀▀ █▀█ █▀▄   █▀▀ █▀▄ █▀▀ █▀▀
              ▀▀▀  ▀  ▀  ▀    ▀▀▀  ▀     ▀  ▀▀▀ ▀▀▀ ▀▀▀ ▀▀▀   ▀▀▀ ▀     ▀ ▀ ▀ ▀   ▀▀▀  ▀  ▀▀▀ ▀▀▀   ▀▀▀ ▀   ▀▀▀ ▀▀▀ ▀▀▀ ▀   ▀  ▀▀▀   ▀▀  ▀ ▀ ▀▀▀ ▀ ▀ ▀ ▀   ▀   ▀ ▀ ▀▀▀ ▀▀▀  ▄▀
                       █ █ █▀█ █ █  █▄█░█ █ █▀▀ ▀█▀   █▀▄ █▀▀ █▀█ █▀▀ █ █   ▀█▀ █ █ █▀▀   █▀▀ █▀▀ █▀█ ▀█▀ █▀▀ █▀▄  █▀█ █▀▀   ▀█▀ █ █ ▀█▀ █▀▀   █▄█ █▀█ ▀▀█ █▀▀
                        █  █ █ █ █  █ █ █ █ ▀▀█  █    █▀▄ █▀▀ █▀█ █   █▀█    █  █▀█ █▀▀   █   █▀▀ █ █  █  █▀▀ █▀▄  █ █ █▀▀    █  █▀█  █  ▀▀█   █ █ █▀█ ▄▀  █▀▀
                        ▀  ▀▀▀ ▀▀▀  ▀ ▀ ▀▀▀ ▀▀▀  ▀    ▀ ▀ ▀▀▀ ▀ ▀ ▀▀▀ ▀ ▀    ▀  ▀ ▀ ▀▀▀   ▀▀▀ ▀▀▀ ▀ ▀  ▀  ▀▀▀ ▀ ▀  ▀▀▀ ▀      ▀  ▀ ▀ ▀▀▀ ▀▀▀   ▀ ▀ ▀ ▀ ▀▀▀ ▀▀▀ ▀  ▀  ▀